    ####
  ###  #
###    #
#@$$#. #
#     ##
### # # 
  #  .# 
  ##### 
