####
#  ###
# *$.##
#     #
###  @#
  #   #
  #####