        #####
#########   #
#.       .  #
# ###### #$##
# ###### # # 
#     @$ # # 
########   # 
       ##### 
