 ####
 #  ####
 #     #
##$.. .#
#  ##@##
# $$  #
#     #
#######