  ####
  #  #
###$.#
#  $.#
# #$.#
# #@ #
# #  #
#    #
######