#########
#  ##   #
#   $$  #
# @#$. ##
##  ..##
 #  ###
 ####