     #####  
     #   ###
######$.  .#
#    @$ ## #
# #####.$  #
#        ###
#######  #  
      ####  
