 #####  
 #   #  
 # #$#  
 # $@#  
 # # #  
 # # #  
 # # ###
## #   #
# $.$. #
#  .#  #
###  .##
  ##### 
