  ######
### .  #
# $  $ #
# @#* .#
# $ .$##
## .  #
 ######