 #####     
##   #     
#. * ######
# #$      #
# ..###$ .#
## $   $ ##
 # @###  # 
 ######### 
