######
# *  #
#  * #
#* $ #
#@$. #
# . ##
#####